{
  "Level": "Level 1",
  "Layers": [
    "GAAAAAAAAAAAAAAAAAAAAAAAAAAAAAAAAAAAAAA",
    "GAAAAAAAAAAAAAAAAAAAAAAAAAAAAAAAAAAAAAA",
    "GAAAAAAAAAAAAAAAAAAAAAAAAAAAAAAAAAAAAAA",
    "GAAAAAAAAAAAAAAAAAAAAAAAAAAAAAAAAAAAAAA",
    "GAPAAAAAAAAAAAAAAAAAAAAAAAAAAAAAAAAAAAA",
    "GAAAAAAAAAAAAAAAAAAAAAAAAAAAAAAAAAAAAAA",
    "GAAAAAAAAAAAAAAAAAAAAAAAAAAAEAAAAAAAAAA",
    "GAGGGAAAAAAGAAAAAAAAAAAAAAAGGGAAAAAAAAA",
    "GAAAAAAAGAAGAAAAAAAAAAAAAAAAAAAAAAAAEAA",
    "GAAAAAAAGAAGAAAAAAAAAEAAAEAAAAEAGGGGGGGAAAAAAAAAAAC",
    "GGGGGGGGGGGGAAAGGGGGGGGGGGGGGGGGGGGGGGGGGGGGGGGGGGGGGGGGGGGGGGGGGGG"
  ]

}