{
  "Level": "Level 1",
  "Layers": [
    "GAAAAAAAAAAAAAAAAAAAAAAAAAAAAAAAAAAAAAA",
    "GAAAAAAAAAAAAAAAAAAAAAAAAAAAAAAAAAAAAAA",
    "GAAAAAAAAAAAAAAAAAAAAAAAAAAAAAAAAAAAAAA",
    "GAAAAAAAAAAAAAAAAAAAAAAAAAAAAAAAAAAAAAA",
    "GAAAAAAAAAAAAAAAAAAAAAAAAAAAAAAAAAAAAAA",
    "GAAAAAAAAAAAAAAAAAAAAAAAAAAAAAAAAAAAAAA",
    "GAAAAAAAAAAAAAAAAAAAAAAAAAAAEAAAAAAAAAA",
    "GAGGGAAAAAAGAAAAAAAAAAAAAAAGGGAAAAAAAAA",
    "GAPAAAAAGAAGAAAAAAAAAAAAAAAAAAAAAAAAEAA",
    "GAAAAAAAGAAGAAAAAAAAAEAAAEAAAAEAGGGGGGGAAAAAAAAAAAC",
    "GGGGGGGGGGGGAAAGGGGGGGGGGGGGGGGGGGGGGGGGGGGGGGGGGGGGGGGGGGGGGGGGGGG"
  ]

}